*****
*---*
*---*
*---*
*****